1111111111111
10C1000A000C1
1000C11111A01
1P0011E000001
1111111111111